NO ./assets/brickwall.png
SO ./assets/brickwall01.png

WE ./assets/brickwall03.png
EA ./assets/brickwall04.png


F 225,100,9
C 56,15,120


111111111111111111111111111111111111111
100100000000000000000000011111111111111
100000000000000000000000011111110000001
100100000000000000000000111011000000001
100000000000010000000000111111111111101
1000000000000000000000001
1000000000000000000000001
1000000000000000000000001
1000000000000100000000001
1000000000000000000000001
1000000000000000000000001
1000000000000000000000001
1000000000000000000000001
1000000000000000000000001
1000000000000000000000001
1000000000000000000000001
1000000000000000000000001
1000000000000000000000001
1111111N11111111111111111
