NO ./assets/Animal_02-256x256.png
SO ./assets/Wall_05-128x128.png

WE ./assets/Textures-16.png
EA ./assets/Ground_08-128x128.png


F 225,100,9
C 56,15,120


111111111111111111111
1001000000000000000000001
1000000000000000000000001
1001000000000000000000001
1000000000000100000000001
1000000000000000000000001
1000000000000000000000001
1000000000000000000000001
1000000000000100000000001
1000000000000000000000001
1000000000000000000000001
1000000000000000000000001
1000000000000000000000001
1000000000000000000000001
1000000000000000000000001
1000000000000000000000001
1000000000000000000000001
1000000000000000000000001
1111111111111111111111111
