NO ./assets/brickwall.png
SO ./assets/brickwall01.png

WE ./assets/brickwall03.png
EA ./assets/brickwall04.png


F 225,100,9
C 56,15,9

11111
10N01
1111
