NO ./assets/brickwall.png
SO ./assets/brickwall01.png

WE ./assets/brickwall03.png
EA ./assets/brickwall04.png


F 225,100,9
C 56,15,120


1111111111111111111111111
1001000000000000000000001
1000000000000000000000001
1001000000000000000000001
1000000000000100000000001
1000000000000000000000001
1000000000000000000000001
1000000000000008000000001
1000000000000100000000001
1000000000000000000000001
1000000000000000000000001
10000000j0000000000000001
10000000000S0000000000001
1000000000000000000000001
1000000000000000000000001
1000000000000000000000001
1000000000000000000000001
1000000000000000000000001
1111111111111111111111111
