NO ./assets/brickwall.png
SO ./assets/brickwall01.png

WE ./assets/brickwall03.png
EA ./assets/brickwall04.png


F 225,100,9
C 56,15,120

111
101
111
              11111
              100N1
              11111