NO ./assets/brickwall.png
SO ./assets/brickwall01.png

WE ./assets/brickwall03.png
EA ./assets/brickwall04.png


F ./assets/stone01.png
C ./assets/diamondore.png


1111111111111111111111111
1001000000000000000000001
1000000000000000000000001
1001000000000000000000001
10000000000001000000W0001
1000000000000000000000001
1000000000000000000000001
1000000000000000000000001
1000000000000100000000001
1000000000000000000000001
1000000000000000000000001
1000000000000000000000001
1000000000000000000000001
1000000000000000000000001
1000000000000000000000001
1000000000000000000000001
1000000000000000000000001
1000000000000000000000001
1111111111111111111111111
