NO ./assets/brickwall.png
SO ./assets/brickwall01.png
WE ./assets/brickwall03.png
EA ./assets/brickwall04.png
F ./assets/stone01.png
C ./assets/diamondore.png

1111111111111111111111111111111111111111111111111111111
1001000000000000000000000000000000000000000000000000001
10000000000100000000D0000010000000100000000000000000001
100100000010000000000000010000000001000000000000000001
100000000010010S0000000000000010001000000000000000001
1000000000000000000000000000001001000000000000000001
100000000000000000000000111111111111111111111111111
1000000000000000000000001
1110000000000000000000001
1000100000000000000000001
1111000000000000000000001
1000000001111110000000001
1000000001    10000000001
1000000001    10000000001
1000000001111110000000001
1000000000000000000000001
1000000000000000000000001
1000000000000000000000001
1111111111111111111111111
